+ - + - - - - - - +
| S |             |
|   |   + - - +   |
|       |     |   |
| - - - +     |   |
|   + - +     +   |
|                 |
|     +   - - +   |
|           E |   |
+ - - - - - - - - +
