##########
#S#      #
# # #### #
#   #  # #
#####  # #
#  ## ## #
#        #
#  # ### #
#     E# #
##########